11111111111
10000000001
1P0000C0001
11111111101
1E000000001
11111111111
